111111111
10C0E0001
100P00001
111111111
