111111111111111111111111111111111111111111111111
10000000000000PCE0000000000000000000000000000001
111111111111111111111111111111111111111111111111