11111111111111111111111111111111111111111111111111111111111
1C000000000000000000000000000000000000000000000000000000001
1100000000000000000000000000000000000000E000000000000000001
1000000C0000000000000000000P0000C00000000000000000000000001
1000000000000000000000000C000000000000000000000000000000001
10000000000000000000000000000000000000000000000000000000001
10000000000000000000000000000000000000000000000000000000001
10000000000000000000001CCCC10000000000000000000000000000001
10000000000000000000001CCCC10000000000000000000000000000001
10000000000000000000001CCCC10000000000000000000000000000001
10000000000000000000001CCCC10000000000000000000000000000001
10000000000000000000001CCCC10000000000000000000000000000001
10000000000000000000001CCCC10000000000000000000000000000001
10000000000000000000001CCCC10000000000000000000000000000001
10000000000000000000001CCCC10000000000000000000000000000001
10000000000000000000001CCCC10000000000000000000000000000001
11111111111111111111111111111111111111111111111111111111111
