111111111111111111111111111111111111111111111111
1C0000000000000000000000000000000000000000000001
110000000000000000000000000000000000000000000001
100000000000000000000000000P00000000000000000001
1000000000000000000E0000000000000000000000000001
100000000000000000000000000000000000000000000001
111111111111111111111111111111111111111111111111
