1111111111111111
1000000000000001
1000000C00000001
1P000C0000E00001
1111111111111111
